10000000
00006000
00099000
00099000
00060000
09000020