000000600000000000000000000000000
010000000000000000000000000000000
000000000000000000000000000000000
000000000000000000000000000000000
000000000000000000000009999999000
000000000009990999999999900000000
000000000009990999999000000000000
000000000009990999000000000000000
000000000000099000009999999999999
000000000060099000600000000000000
000999999999999000000000000000000
000999999999999000000000000000000
000000000000000000000000000000000
000000000000000000000000000000000
000000000000000000000000000000000
000000000000000000000000000000020
000000000000000000000000060000000