1000000090000000
0000600000006000
0009900000099000
0009900000099000
0006000000060000
0900009009000090
9000000090000000
0000600000006000
0009900000099000
0009900000099000
0006000000060000
0900009009000020